SO textures/south.png
NO textures/north.png
WE textures/west.png
EA textures/east.png

F 165,150,150
C 20,20,240

 11111111111
100W001000001
1100000000011
1100011100011
1111111111111 